Lawrence Jobb
Ramona	Bass
Terence	Bowman
Gloria	Dean
Traci	Boone
Miranda	Craig
Hope	Marshall
Josephine Fletcher
Sam	Carson
Joanna	Ballard
Monique	Hammond
Merle	Tran
Samantha	Armstrong
Olivia	Ford
Cristina	Swanson
Derrick	Malone
Tricia	Holmes
Esther	Henry
Kurt	Ramirez
Matt	Cannon
Dana	Brady
